3302222044
3002221004
0001100000
0221000650
0221221110
0111221220
0340001220
0000011000
5001222006
5502222066
