3331554333
3000212003
3121221213
1221220614
5216012125
5212106125
4160221221
3121221213
3002120003
3334551333
