3021021204
3021121204
2222002222
1121101211
2201221010
0100221022
1121111211
2222002222
5021211206
5021201206
