3331221444
3021121104
3122002224
1121121211
2201221012
2102221022
1121111211
5222002216
5011211206
5551221666
