3300000044
3002122004
0001501000
0221261220
2121111212
2121111212
0221321220
0001041000
5002212006
5500000066
