3331554333
3012221103
3022116203
1011620124
5222012215
5122102225
4210261101
3026112203
3011222103
3334551333
