3000000004
0002215000
0002216000
2211110010
2210220110
0110220122
0100111122
0004122000
0003122000
5000000006
