3001221004
0021221200
0222002220
1121101211
0201221010
0100221020
1121111211
0222002220
0021221200
5001221006
