3331222444
3000010004
3221221014
1221220612
2215010122
2210104122
2130221221
5101221226
5000100006
5552221666
