3300000044
3021001204
0221001220
0111001110
0222002220
0222002220
0111001110
0221001220
5021001206
5500000066
