3300000044
3001221004
0001220220
0220101011
0220220220
0220220220
1101010220
0220221000
5001221006
5500000066
