3000000004
3002122004
0001501000
0221001220
2121111212
2121111212
0221001220
0001041000
5002212006
5000000006
