3330110444
3002222004
3022222204
0222112220
1221111221
1221111221
0222112220
5022222206
5002222006
5550110666
