3302112044
3002222004
0002222000
2222112222
1221111221
1221111221
2222112222
0002222000
5002222006
5502112066
