3321021244
3021121204
2122002222
1121101211
2201221012
2100221022
1121111211
2222002212
5021211206
5521201266
