3334554333
3001111003
3061220603
4111222214
5122112215
5122112215
4122221114
3060221603
3001111003
3334554333
