3002222004
3002211004
0001110000
0221006510
0221221110
0111221220
0134001220
0000111000
4001122006
4002222006
