3334554333
3011211003
3022216003
4211116214
5212222115
5112222125
4126111124
3006122203
3001121103
3334554333
