3330001444
3022221204
3022220204
0110001010
0220221220
0221220220
0101000110
5020222206
5021222206
5551000666
