3000220004
0000221100
0022116000
1011500010
0022012220
0222102200
0100041101
0003112200
0011220000
5000220006
