3330000444
3002212004
3001061004
0221521220
2121111212
2121111212
0221241220
5001301006
5002122006
5550000666
