3331551333
3041121103
3142662443
1101121011
5261121615
5162221625
1101111011
3442662413
3011211403
3331551333
