3000220004
0001111000
0050221600
0101221110
2122002212
2122002212
0111221010
0031220400
0001111000
5000220006
