3000000004
3002211004
0002215000
2211116012
2210220112
2110220122
2104111122
0003122000
5001122006
5000000006
