3000000004
3002215004
0002216000
2211110012
2200220012
2100220022
2100111122
0004122000
5003122006
5000000006
