3001221004
0021221200
0222002220
1121111211
0101220020
0201221010
1121011211
0222002220
0021221200
5001221006
