3000000004
3000000004
0221001220
0221001220
0111221110
0111221110
0221001220
0221001220
5000000006
5000000006
