3334554333
3062112603
3002222003
4211111124
5122662225
5222662215
4211111124
3002222003
3062112603
3334554333
