3000000004
3002222004
0002222000
0211111120
0210110120
0210110120
0211111120
0002222000
5002222006
5000000006
