3331554333
3021222203
3020222223
4601660164
5121221215
5121221215
4610661064
3222220203
3022221203
3334551333
