3330220444
3001111004
3050221604
0102221110
2122122212
2122212212
0111222010
5031220406
5001111006
5550220666
