3330220444
3001111004
3051220604
0111222010
2122212212
2122122212
0102221110
5030221406
5001111006
5550220666
