3001000004
0001022000
0000022000
0101000010
0220220220
0220220220
0100001010
0002200000
0002201000
5000001006
