3000220004
0002112000
0000220000
0211111120
0100110010
0100110010
0211111120
0000220000
0002112000
5000220006
