3321201244
3021211204
2222002212
1121111211
2101220022
2201221012
1121011211
2122002222
5021121206
5521021266
