3331221444
3011211204
3222002214
1121111211
2101222022
2201221012
1121211211
5122002226
5021121106
5551221666
