3001000004
0000021000
0021220010
0021220610
2215010122
2210104122
0130221200
0100221200
0001200000
5000001006
