3330220444
3002215004
3002216004
2211110022
2210220122
2210220122
2200111122
5004122006
5003122006
5550220666
