3000000004
0002112000
0001001000
0201001020
2121111212
2121111212
0201001020
0001001000
0002112000
5000000006
