3330000444
3002002004
3221001224
0221001220
2111221112
2111221112
0221001220
5221001226
5002002006
5550000666
