3300001044
3002221204
0002220200
0110001010
0221220220
0220221220
0101000110
0020222000
5021222006
5501000066
