3330000444
3001221004
3221220224
0220011011
0220220220
0220220220
1101100220
5220221226
5001221006
5550000666
