3334551333
3022221203
3222220203
4610661064
5121221215
5121221215
4601660164
3020222223
3021222203
3331554333
