3334114333
3050220503
3562222653
4022112204
1221111221
1221111221
4022112204
3562222653
3050220503
3334114333
