3300000044
3002222004
0002222000
2211111122
2210110122
2210110122
2211111122
0002222000
5002222006
5500000066
