3334554333
3002212003
3601221063
4221221224
5121661215
5121661215
4221221224
3601221063
3002122003
3334554333
