3001000004
3001222004
0000222000
0101000110
0220220220
0220220220
0110001010
0002220000
5002221006
5000001006
