3334554333
3002222003
3062222603
4211111124
5210110125
5210110125
4211111124
3062222603
3002222003
3334554333
