3000001004
3002221004
0002220000
0110001010
0220220220
0220220220
0101000110
0000222000
5001222006
5001000006
