3331551333
3011211403
3442662413
1101111011
5161222625
5261211615
1101211011
3142662443
3041121103
3331551333
