3300220044
3001111004
0051220600
0111222010
2122012212
2122102212
0102221110
0030221400
5001111006
5500220066
