3332222444
3002222004
3001110004
0221000650
2221221112
2111221222
0340001220
5000111006
5002222006
5552222666
