3330220444
3011211004
3022215004
2211116012
2210220112
2110220122
2104111122
5003122206
5001121106
5550220666
