3334554333
3002212003
3001112003
4221226664
5221221115
5111221225
4666221224
3002111003
3002122003
3334554333
