3300000044
3002215004
0002216000
2211110012
2210220022
2200220122
2100111122
0004122000
5003122006
5500000066
