3330000444
3001221004
3220221224
1101100220
0220220220
0220220220
0220011011
5221220226
5001221006
5550000666
