3302222044
3002211004
0021110000
0121006510
0221221110
0111221220
0134001210
0000111200
5001122006
5502222066
