3330220444
3021001204
3221001224
0111001110
0222002220
0222002220
0111001110
5221001226
5021001206
5550220666
