3301000044
3021222004
0020222000
0101000110
0220221220
0221220220
0110001010
0002220200
5002221206
5500001066
