3002200004
0002211000
0001110000
0221000650
0221221110
0111221220
0340001220
0000111000
0001122000
5000022006
