3000000004
0000000000
0021001200
0221001220
0111221110
0111221110
0221001220
0021001200
0000000000
5000000006
