3332222444
3002222004
3002222004
2211111122
2210110122
2210110122
2211111122
5002222006
5002222006
5552222666
