3001000004
3000012004
0021220010
0221220610
2215010122
2210104122
0130221220
0100221200
5002100006
5000001006
