4022000000
0000000000
0000000000
0000002200
0000000000
0000000000
0000000000
0000000000
0000000000
0000000000
