3331000444
3021222204
3020222204
0101000110
0221220220
0220221220
0110001010
5022220206
5022221206
5550001666
