3334554333
3001111003
3060221603
4122221114
5122112215
5122112215
4111222214
3061220603
3001111003
3334554333
