3301220044
3000010004
0221221010
0221220610
2215010122
2210104122
0130221220
0101221220
5000100006
5500221066
