3002112004
3002222004
0000220000
0222112220
0221111220
0221111220
0222112220
0000220000
5002222006
5002112006
