3331222444
3022221104
3022116004
1011500102
2022012212
2122102202
2010041101
5003112206
5011222206
5552221666
