3000220004
3001111004
0050221600
0101221110
2122202212
2122022212
0111221010
0031220400
5001111006
5000220006
