3300000044
3000000004
0221001220
0221001220
2111221112
2111221112
0221001220
0221001220
5000000006
5500000066
