3000000004
0021001200
0221001220
0111001110
0222000000
0222000000
0111001110
0221001220
0021001200
5000000006
