3300000044
3001211004
0022215000
2211116012
2210220112
2110220122
2104111122
0003122200
5001121006
5500000066
