3000000004
0001221000
0000220000
1101000220
0000220220
0220220000
0220001011
0000220000
0001221000
5000000006
