3002222004
3002211004
0001000000
0221000650
0221221110
0111221220
0340001220
0000001000
5001122006
5002222006
