3334554333
3002216003
3002216003
4211116224
5212222115
5112222125
4226111124
3006122003
3006122003
3334554333
