3334554333
3021001203
3221001223
4111661114
5222222225
5222222225
3111661113
4221001224
3021001203
3334554333
