3334554333
3002211003
3121112003
4121226614
5221221115
5111221225
4166221214
3002111213
3001122003
3334554333
