3000000004
0002215000
0002216000
2201110010
2200220010
0100220022
0100111022
0004122000
0003122000
5000000006
