3000000004
3021001204
0221001220
0111001110
0000002220
0000002220
0111001110
0221001220
5021001206
5000000006
