3000000004
0002222000
0002222000
0222112220
0221111220
0221111220
0222112220
0002222000
0002222000
5000000006
