3000001004
0002201000
0002200000
0100001010
0220220220
0220220220
0101000010
0000022000
0001022000
5001000006
