3300000044
3001221004
0220221000
1101010220
0220220220
0220220220
0220101011
0001220220
5001221006
5500000066
