3332222444
3002211004
3121110004
0121006510
0221221110
0111221220
0134001210
5000111216
5001122006
5552222666
