3000000004
3001221004
0001220000
0220001011
0220220220
0220220220
1101000220
0000221000
5001221006
5000000006
